********
* G    *
*****  *
*     **
******S*
*      *
********
