********
* G    *
*****  *
*     **
*  ***S*
*      *
********
